###################################################################################################
#                                                                                                 #
#                                                                                                 #
#                                                                                                 #
#########################                                  ######################                 #
#                       #                                                                         #
#                       #                                                                         #
#                       #                                                                         #
#                       #                                                                         #
#                       #                                                                         #
#                       #                                                                         #
#                       #                                                                         #
#                       #                                                                         #
#                       #                                                                         #
#                       #                                                                         #
#                       #                                                                         #
#                       #                                                                         #
#                ########                                                                         #
#                                                                                                 #
#                                                                                                 #
#                                                                                                 #
#                                        #                                 ########################
#                                        #                                                        #
#                                        #                                                        #
#                                        #                                                        #
#                                        #                                                        #
#                                        #                                                        #
#                                        #                                                        #
#                                        #                                                        #
###################################################################################################