####################################################################################################
#                                                                                                  #
#                                                                                                  #
#                                                                                                  #
#########################                                  ######################                  #
#                       #                                                                          #
#                       #                                                                          #
#                       #                                                                          #
#                       #                                                                          #
#                       #                                                                          #
#                       #                                                                          #
#                       #                                                                          #
#                       #                                                                          #
#                       #                                                                          #
#                       #                                                                          #
#                       #                                                                          #
#                       #                                                                          #
#                ########                                                                          #
#                                                                                                  #
#                                                                                                  #
#                                                                                                  #
#                                        #                                 #########################
#                                        #                                                         #
#                                        #                                                         #
#                                        #                                                         #
#                                        #                                                         #
#                                        #                                                         #
#                                        #                                                         #
#                                        #                                                         #
####################################################################################################