####################################################################################################
#                                                                        #                         #
#                                                                        #                         #
#                                                                        #                         #
#                                           #                            #                         #
#                                           #                            #                         #
#                                           ################################                       #
#                                           #                          # # #                       #
#                                           #                         #     #                      #
#                                           #                        #       #                     #
#                                           #                       #         #                    #
#                                                                                                  #
#                                                                                                  #
#                                                                                                  #
#                                                                                                  #
#                       ############                                                               #
#                       #                                                                          #
#########################                #                                                         #
#                                        #                                                         #
#                                        #                                                         #
#                                        #                                                         #
#                                        #                                 ####################    # 
#                                        #                                           #             #
#                                        #                                           #             #
#                                        #                                           #             #
#                                        #                                           #             #
#                                        #                                                         #
#                                        #                                                         #  
#                                        #                                                         #
####################################################################################################