###################################################################################################
#                                                                        #                        #
#                                                                        #                        #
#                                                                        #                        #
#                                           #                            #                        #
#                                           #                            #                        #
#                                           ################################                      #
#                                           #                          # # #                      #
#                                           #                         #     #                     #
#                                           #                        #       #                    #
#                                           #                       #         #                   #
#                                                                                                 #
#                                                                                                 #
#                                                                                                 #
#                                                                                                 #
#                       ############                                                              #
#                       #                                                                         #
#########################                #                                                        #
#                                        #                                                        #
#                                        #                                                        #
#                                        #                                                        #
#                                        #                                 ########################
#                                        #                                           #            #
#                                        #                                           #            #
#                                        #                                           #            #
#                                        #                                           #            #
#                                        #                                                        #
#                                        #                                                        #
#                                        #                                                        #
###################################################################################################